-14
14
-11
11
1111111111111111111111111111

1111111111111111111111111111

1111111111111111111111111111

1110000000000000001100000111

1110000000000000001100000111

1110000000000000001100000111

1110000000000000001100000111

1110000000000000000000000111

1110000000000000000000000111

1110000000000000000000000111

1110000000000000000011111111

1110000000000000000011111111

1110000000000000000000000111

1110001100000011100000000111

1110001100000011100000000111

1110000000000000000000000111

1110000000000000000000000111

1110000000000000000000000111

1110000000000000000000000111

1111111111111111111111111111

1111111111111111111111111111

1111111111111111111111111111

